NO ./imgs/wall1.xpm
SO ./imgs/wall2.xpm
WE ./imgs/wall3.xpm
EA ./imgs/wall4.xpm

F 220,100,0
C 225,30,0

11111
10011
10N01
10001
11111