NO ./imgs/no.xpm
SO ./imgs/so.xpm
WE ./imgs/we.xpm
EA ./imgs/ea.xpm


F 220,100,0
C 225,30,0

1111
1E01
1101
1011

gghigj