NO ./imgs/no.xpm
SO ./imgs/so.xpm
WE ./imgs/we.xpm
EA ./imgs/ea.xpm


F 220,100,0
C 225,30,0

    11
    101
 11111111        1  
 1100200011111  101
 10020011      1001
1000000111    1011
1111000020111111111
   11N0002000001
111111111111111111
   101
   111
